http://www.sourcecode.se/sokoban/levelgraph.php?file=AlbertoG1-1.slc&page=0
o o o o o o o o o o o o w w w w w w w o o o o o o
o o o o o o w w w w f f w f f w f f w w w w w w w
o o o o o o w f f w w w w f f w f f f f f f f f w
w w w w w w w w f f f f f f f w f w f f f w f f w
w f f f f f d w f f f f w w f w d w w w w w f w w
w f f f f f f f f f f f w f f w f w f f f w f f w
w f f w w w d w f w w w w f f f f f f d f f f f w
w w w w f w w w f f d f f f f f w w w w f f f w w
o o o o o o w f f f w f f f f w w f f w w f f w o
o o o o o o w w w d d d f w w w f f f f w w w w o
o o o o o o o o w w w w w w o o o o o o o o o o o
s 208
b 87 110 111 112 115 164 188 198
