http://games.co.za/funny-quest.html L7
w w w w w w w w
w w d d f f d w 
w w w f w f w w 
w d f f w f w w 
w f w f f f w w 
w f f f f f w w 
w f f f f f w w 
w f f f f d d w 
w w w w w w w w 
s 36
b 28 37 43 44 45 52
