http://games.co.za/funny-quest.html L4
o w w w w w w w o 
o w f f d d d w o 
o w f f f w w w w 
w w w f f f f f w 
w f f f w f w f w 
w f f f w f f f w 
w f f f w w w w w 
w w w w w o o o o 
s 13
b 31 42 48
H 34 Jorge Miguel
