http://games.co.za/funny-quest.html L2
o o o o o o w w w w
o w w w w w w f d w
o w f f f f f f f w
o w f f f f f f f w
o w f f f f f f f w
w w f f w w w w f w
w d f f f f f f f w
w w w w w w w w w w
s 44
b 54 59
H 19 angela Fernandes
