http://games.co.za/funny-quest.html L5
w w w w w o o o o 
w f f f w o o o o 
w f f f w o w w w 
w f f f w o w d w 
w w w f w w w d w 
o w w f f f f d w 
o w f f f w f f w 
o w f f f w w w w 
o w w w w w o o o 
s 11
b 21 22 30
H 89 Nome
