http://games.co.za/funny-quest.html L1
o w w w w w w w w w
w f f f f d w d w w
w f f f w w w f w w
w f f f f f f f f w
w f f f w f w f f w
w f f f f f f f f w
w f w f f f f f f w
o w w w w w w w w w
s 62
b 37 56
H 15 andre
