http://games.co.za/funny-quest.html L6
o w w w w w w w o 
w w f f d f f w w 
w d f w f w f d w 
w f f f d f f f w 
w f f f d f f f w 
w w w f f f w w w 
o o w f w f w o o 
o o w d f d w o o 
o o w w w w w o o 
s 50
b 23 31 33 40 42 49 51
