http://games.co.za/funny-quest.html L8
o w w w w w w w o o 
o w f f f f f w w w 
w w f w w w f f f w 
w f f f f f f f f w 
w f d d w f f f w w 
w w d d w f f f w o 
o w w w w w w w w o 
s 33
b 23 35 38 47