http://www.game-sokoban.com/ L1
o o o o o o o w w w w w w w w w w w o
o o o o o o o w f f f f f f f f f w o
o o o o o o o w f f f f f f f f f w o
w w w w w w o w f f f w w w w w f w o
w f f f f w w w w w f f f f w w f w o
w f f f f f f f f f f f f f f f f w o
w f f f f f f f f f f w w f w w f w o
w f f f f w w f w w w w w f w w f w o
w f f f f w w w w o o o w f w w f w w
w d d d d w o o o o o o w f f f f f w
w d d d d w o o o o o o w f f f f f w
w w w w w w o o o o o o w w w w w w w
s 141
b 51 53 67 88 93 104 106 186

